,tournament,fullname,Count_Win,Count_Lose,total_play,perc_win
0,Australian Open,Adrian Mannarino,5,10,15,33.33
1,Australian Open,Adrian Voinea,6,4,10,60.0
2,Australian Open,Agustin Calleri,4,9,13,30.769999999999996
3,Australian Open,Albert Costa,7,5,12,58.330000000000005
4,Australian Open,Albert Montanes,4,13,17,23.53
5,Australian Open,Albert Portas,2,5,7,28.57
6,Australian Open,Albert Ramos,3,7,10,30.0
7,Australian Open,Alberto Martin,6,8,14,42.86
8,Australian Open,Alejandro Falla,7,7,14,50.0
10,Australian Open,Alex Bogomolov Jr,2,6,8,25.0
12,Australian Open,Alex Calatrava,3,3,6,50.0
13,Australian Open,Alex Corretja,2,4,6,33.33
14,Australian Open,Alex De Minaur,3,3,6,50.0
19,Australian Open,Alexander Zverev,7,4,11,63.63999999999999
20,Australian Open,Alexandr Dolgopolov,11,8,19,57.89
24,Australian Open,Amer Delic,5,4,9,55.559999999999995
26,Australian Open,Andre Agassi,30,2,32,93.75
31,Australian Open,Andreas Seppi,20,14,34,58.81999999999999
32,Australian Open,Andreas Vinciguerra,8,4,12,66.67
34,Australian Open,Andrei Pavel,8,8,16,50.0
35,Australian Open,Andrew Ilie,5,4,9,55.559999999999995
37,Australian Open,Andrey Golubev,2,6,8,25.0
38,Australian Open,Andrey Kuznetsov,5,4,9,55.559999999999995
39,Australian Open,Andrey Rublev,3,3,6,50.0
40,Australian Open,Andy Murray,48,13,61,78.69
41,Australian Open,Andy Roddick,38,11,49,77.55
43,Australian Open,Antony Dupuis,2,5,7,28.57
44,Australian Open,Arnaud Clement,12,11,23,52.17
48,Australian Open,Benjamin Becker,5,9,14,35.709999999999994
49,Australian Open,Benoit Paire,5,8,13,38.46
50,Australian Open,Bernard Tomic,17,10,27,62.96000000000001
51,Australian Open,Bjorn Phau,2,8,10,20.0
52,Australian Open,Blaz Kavcic,5,7,12,41.67
54,Australian Open,Bobby Reynolds,2,5,7,28.57
55,Australian Open,Bohdan Ulihrach,3,4,7,42.86
57,Australian Open,Borna Coric,3,5,8,37.5
62,Australian Open,Carlos Berlocq,3,8,11,27.27
63,Australian Open,Carlos Moya,6,9,15,40.0
65,Australian Open,Cecil Mamiit,1,5,6,16.669999999999998
67,Australian Open,Chris Guccione,2,6,8,25.0
68,Australian Open,Chris Woodruff,6,2,8,75.0
69,Australian Open,Christophe Rochus,8,10,18,44.440000000000005
70,Australian Open,Cyril Saulnier,1,5,6,16.669999999999998
71,Australian Open,Damir Dzumhur,5,5,10,50.0
73,Australian Open,Daniel Brands,2,5,7,28.57
74,Australian Open,Daniel Evans,4,3,7,57.14
75,Australian Open,Daniel Gimeno Traver,1,7,8,12.5
78,Australian Open,Daniil Medvedev,4,3,7,57.14
79,Australian Open,David Ferrer,41,16,57,71.93
80,Australian Open,David Goffin,11,6,17,64.71000000000001
81,Australian Open,David Nalbandian,26,10,36,72.22
83,Australian Open,David Sanchez,2,5,7,28.57
84,Australian Open,Davide Sanguinetti,1,7,8,12.5
85,Australian Open,Denis Gremelmayr,3,4,7,42.86
86,Australian Open,Denis Istomin,11,13,24,45.83
87,Australian Open,Denis Kudla,3,6,9,33.33
90,Australian Open,Diego Sebastian Schwartzman,6,5,11,54.55
91,Australian Open,Dmitry Tursunov,5,10,15,33.33
92,Australian Open,Dominic Thiem,10,6,16,62.5
93,Australian Open,Dominik Hrbaty,19,9,28,67.86
94,Australian Open,Donald Young,6,9,15,40.0
95,Australian Open,Dudi Sela,9,12,21,42.86
96,Australian Open,Dusan Lajovic,3,6,9,33.33
97,Australian Open,Edouard Roger Vasselin,5,5,10,50.0
100,Australian Open,Ernests Gulbis,2,9,11,18.18
101,Australian Open,Evgeny Donskoy,5,4,9,55.559999999999995
102,Australian Open,Evgeny Korolev,4,4,8,50.0
103,Australian Open,Fabio Fognini,10,12,22,45.45
104,Australian Open,Fabrice Santoro,13,11,24,54.169999999999995
105,Australian Open,Federico Delbonis,2,6,8,25.0
107,Australian Open,Feliciano Lopez,22,17,39,56.410000000000004
108,Australian Open,Felix Mantilla,3,6,9,33.33
109,Australian Open,Fernando Gonzalez,20,10,30,66.67
110,Australian Open,Fernando Verdasco,24,16,40,60.0
111,Australian Open,Fernando Vicente,5,5,10,50.0
113,Australian Open,Filippo Volandri,1,9,10,10.0
114,Australian Open,Flavio Cipolla,2,4,6,33.33
115,Australian Open,Florent Serra,5,8,13,38.46
116,Australian Open,Florian Mayer,12,12,24,50.0
117,Australian Open,Frances Tiafoe,5,3,8,62.5
118,Australian Open,Francisco Clavet,5,4,9,55.559999999999995
119,Australian Open,Franco Squillari,3,4,7,42.86
120,Australian Open,Frank Dancevic,1,5,6,16.669999999999998
121,Australian Open,Frederico Gil,3,3,6,50.0
123,Australian Open,Gael Monfils,26,14,40,65.0
125,Australian Open,Gaston Gaudio,8,8,16,50.0
127,Australian Open,Gilles Muller,12,12,24,50.0
128,Australian Open,Gilles Simon,24,13,37,64.86
130,Australian Open,Go Soeda,2,5,7,28.57
133,Australian Open,Greg Rusedski,6,4,10,60.0
135,Australian Open,Grigor Dimitrov,23,9,32,71.88
136,Australian Open,Guido Pella,1,5,6,16.669999999999998
138,Australian Open,Guillermo Canas,11,7,18,61.11
139,Australian Open,Guillermo Coria,9,5,14,64.29
140,Australian Open,Guillermo Garcia Lopez,15,14,29,51.72
141,Australian Open,Gustavo Kuerten,4,5,9,44.440000000000005
144,Australian Open,Hicham Arazi,9,5,14,64.29
145,Australian Open,Hyeon Chung,7,3,10,70.0
146,Australian Open,Hyung Taik Lee,2,7,9,22.220000000000002
147,Australian Open,Igor Andreev,7,8,15,46.67
148,Australian Open,Igor Kunitsyn,2,5,7,28.57
150,Australian Open,Illya Marchenko,2,6,8,25.0
152,Australian Open,Ivan Dodig,6,8,14,42.86
153,Australian Open,Ivan Ljubicic,13,13,26,50.0
156,Australian Open,Ivo Karlovic,15,16,31,48.39
157,Australian Open,Jack Sock,4,5,9,44.440000000000005
158,Australian Open,James Blake,21,9,30,70.0
159,Australian Open,James Duckworth,3,7,10,30.0
161,Australian Open,Jan Hajek,1,5,6,16.669999999999998
162,Australian Open,Jan Hernych,4,6,10,40.0
165,Australian Open,Jan Michael Gambill,2,6,8,25.0
168,Australian Open,Janko Tipsarevic,12,10,22,54.55
169,Australian Open,Jarkko Nieminen,17,14,31,54.84
173,Australian Open,Jean Rene Lisnard,3,5,8,37.5
175,Australian Open,Jeremy Chardy,11,11,22,50.0
176,Australian Open,Jerome Golmard,3,4,7,42.86
177,Australian Open,Jerzy Janowicz,6,5,11,54.55
180,Australian Open,Jiri Novak,10,4,14,71.43
181,Australian Open,Jiri Vanek,1,7,8,12.5
182,Australian Open,Jiri Vesely,1,6,7,14.29
183,Australian Open,Jo Wilfried Tsonga,36,11,47,76.6
184,Australian Open,Joachim Johansson,5,4,9,55.559999999999995
185,Australian Open,Joao Sousa,8,7,15,53.33
186,Australian Open,John Isner,13,11,24,54.169999999999995
187,Australian Open,John Millman,4,5,9,44.440000000000005
188,Australian Open,Jonas Bjorkman,7,7,14,50.0
189,Australian Open,Jordan Thompson,2,6,8,25.0
190,Australian Open,Jose Acasuso,2,8,10,20.0
192,Australian Open,Juan Carlos Ferrero,20,11,31,64.52
193,Australian Open,Juan Ignacio Chela,14,11,25,56.00000000000001
194,Australian Open,Juan Martin Del Potro,19,9,28,67.86
195,Australian Open,Juan Monaco,6,11,17,35.29
197,Australian Open,Julien Benneteau,10,13,23,43.480000000000004
199,Australian Open,Jurgen Melzer,14,13,27,51.849999999999994
200,Australian Open,Karen Khachanov,4,3,7,57.14
202,Australian Open,Karol Beck,3,5,8,37.5
203,Australian Open,Karol Kucera,3,5,8,37.5
204,Australian Open,Kei Nishikori,27,9,36,75.0
206,Australian Open,Kevin Anderson,12,11,23,52.17
207,Australian Open,Kevin Kim,3,3,6,50.0
210,Australian Open,Kristof Vliegen,3,5,8,37.5
211,Australian Open,Kyle Edmund,6,5,11,54.55
212,Australian Open,Lars Burgsmuller,4,6,10,40.0
215,Australian Open,Leonardo Mayer,4,9,13,30.769999999999996
216,Australian Open,Lleyton Hewitt,31,17,48,64.58
219,Australian Open,Lucas Pouille,5,6,11,45.45
220,Australian Open,Luis Horna,2,6,8,25.0
222,Australian Open,Lukas Lacko,8,10,18,44.440000000000005
223,Australian Open,Lukas Rosol,4,5,9,44.440000000000005
224,Australian Open,Lukasz Kubot,3,5,8,37.5
226,Australian Open,Magnus Norman,8,2,10,80.0
227,Australian Open,Malek Jaziri,5,5,10,50.0
228,Australian Open,Marat Safin,29,7,36,80.56
229,Australian Open,Marc Gicquel,4,4,8,50.0
231,Australian Open,Marcel Granollers,6,11,17,35.29
232,Australian Open,Marcelo Rios,4,2,6,66.67
235,Australian Open,Marcos Baghdatis,26,14,40,65.0
236,Australian Open,Mardy Fish,14,10,24,58.330000000000005
237,Australian Open,Mariano Zabaleta,4,7,11,36.36
238,Australian Open,Marin Cilic,29,11,40,72.5
239,Australian Open,Marinko Matosevic,1,6,7,14.29
240,Australian Open,Mario Ancic,14,6,20,70.0
242,Australian Open,Mark Philippoussis,9,5,14,64.29
246,Australian Open,Martin Klizan,3,5,8,37.5
248,Australian Open,Matthew Ebden,3,8,11,27.27
250,Australian Open,Max Mirnyi,6,8,14,42.86
252,Australian Open,Michael Berrer,4,6,10,40.0
254,Australian Open,Michael Llodra,5,13,18,27.779999999999998
255,Australian Open,Michael Russell,2,10,12,16.669999999999998
257,Australian Open,Michal Tabara,3,5,8,37.5
258,Australian Open,Michel Kratochvil,4,3,7,57.14
260,Australian Open,Mikhail Kukushkin,3,9,12,25.0
261,Australian Open,Mikhail Youzhny,20,16,36,55.559999999999995
262,Australian Open,Milos Raonic,26,9,35,74.29
264,Australian Open,Mischa Zverev,5,8,13,38.46
266,Australian Open,Nick Kyrgios,11,6,17,64.71000000000001
267,Australian Open,Nicolas Almagro,16,12,28,57.14
268,Australian Open,Nicolas Escude,10,5,15,66.67
270,Australian Open,Nicolas Kiefer,10,7,17,58.81999999999999
271,Australian Open,Nicolas Lapentti,9,8,17,52.94
272,Australian Open,Nicolas Mahut,6,9,15,40.0
273,Australian Open,Nicolas Massu,1,8,9,11.110000000000001
274,Australian Open,Nikolay Davydenko,23,13,36,63.89
275,Australian Open,Nikoloz Basilashvili,4,3,7,57.14
277,Australian Open,Novak Djokovic,67,8,75,89.33
278,Australian Open,Olivier Patience,2,5,7,28.57
279,Australian Open,Olivier Rochus,7,11,18,38.89
281,Australian Open,Oscar Hernandez,1,6,7,14.29
282,Australian Open,Pablo Andujar,2,8,10,20.0
283,Australian Open,Pablo Carreno Busta,8,6,14,57.14
284,Australian Open,Pablo Cuevas,3,7,10,30.0
285,Australian Open,Paolo Lorenzi,2,7,9,22.220000000000002
286,Australian Open,Paradorn Srichaphan,6,8,14,42.86
287,Australian Open,Patrick Rafter,5,1,6,83.33
289,Australian Open,Paul Goldstein,2,4,6,33.33
290,Australian Open,Paul Henri Mathieu,7,10,17,41.18
292,Australian Open,Pete Sampras,11,3,14,78.57
293,Australian Open,Peter Gojowczyk,1,6,7,14.29
294,Australian Open,Peter Luczak,5,8,13,38.46
296,Australian Open,Philipp Kohlschreiber,20,14,34,58.81999999999999
300,Australian Open,Radek Stepanek,15,14,29,51.72
302,Australian Open,Raemon Sluiter,2,7,9,22.220000000000002
303,Australian Open,Rafael Nadal,61,13,74,82.43
304,Australian Open,Rainer Schuettler,14,12,26,53.849999999999994
305,Australian Open,Rajeev Ram,2,4,6,33.33
310,Australian Open,Ricardas Berankis,5,6,11,45.45
311,Australian Open,Ricardo Mello,2,5,7,28.57
313,Australian Open,Richard Gasquet,24,14,38,63.160000000000004
315,Australian Open,Robby Ginepri,7,7,14,50.0
317,Australian Open,Roberto Bautista Agut,15,8,23,65.22
318,Australian Open,Robin Haase,3,11,14,21.43
319,Australian Open,Robin Soderling,5,6,11,45.45
320,Australian Open,Roger Federer,97,14,111,87.39
324,Australian Open,Ryan Harrison,5,9,14,35.709999999999994
326,Australian Open,Sam Querrey,12,12,24,50.0
328,Australian Open,Samuel Groth,3,5,8,37.5
329,Australian Open,Santiago Giraldo,5,8,13,38.46
331,Australian Open,Sargis Sargsian,6,6,12,50.0
332,Australian Open,Scott Draper,1,5,6,16.669999999999998
334,Australian Open,Sebastien Grosjean,25,10,35,71.43
335,Australian Open,Sergiy Stakhovsky,4,8,12,33.33
336,Australian Open,Simone Bolelli,4,6,10,40.0
337,Australian Open,Sjeng Schalken,5,6,11,45.45
338,Australian Open,Slava Dosedel,4,2,6,66.67
340,Australian Open,Stan Wawrinka,37,13,50,74.0
341,Australian Open,Stefan Koubek,12,9,21,57.14
343,Australian Open,Stefanos Tsitsipas,5,2,7,71.43
344,Australian Open,Stephane Robert,6,7,13,46.150000000000006
345,Australian Open,Steve Darcis,2,7,9,22.220000000000002
346,Australian Open,Steve Johnson,5,7,12,41.67
349,Australian Open,Tatsuma Ito,2,5,7,28.57
350,Australian Open,Taylor Dent,7,6,13,53.849999999999994
352,Australian Open,Tennys Sandgren,4,2,6,66.67
353,Australian Open,Teymuraz Gabashvili,2,7,9,22.220000000000002
354,Australian Open,Thanasi Kokkinakis,2,4,6,33.33
356,Australian Open,Thomas Enqvist,3,5,8,37.5
358,Australian Open,Thomas Johansson,17,7,24,70.83
359,Australian Open,Thomaz Bellucci,5,9,14,35.709999999999994
360,Australian Open,Tim Henman,13,6,19,68.42
361,Australian Open,Tim Smyczek,4,5,9,44.440000000000005
362,Australian Open,Tobias Kamke,2,5,7,28.57
364,Australian Open,Todd Martin,9,4,13,69.23
365,Australian Open,Todd Reid,2,4,6,33.33
367,Australian Open,Tomas Behrend,1,5,6,16.669999999999998
368,Australian Open,Tomas Berdych,47,16,63,74.6
370,Australian Open,Tommy Haas,21,12,33,63.63999999999999
371,Australian Open,Tommy Robredo,21,15,36,58.330000000000005
373,Australian Open,Vasek Pospisil,4,3,7,57.14
375,Australian Open,Victor Hanescu,4,11,15,26.669999999999998
376,Australian Open,Viktor Troicki,13,11,24,54.169999999999995
378,Australian Open,Vincent Spadea,3,8,11,27.27
380,Australian Open,Wayne Arthurs,6,8,14,42.86
382,Australian Open,Wayne Ferreira,16,5,21,76.19
385,Australian Open,Xavier Malisse,8,12,20,40.0
386,Australian Open,Yen Hsun Lu,7,11,18,38.89
387,Australian Open,Yevgeny Kafelnikov,12,4,16,75.0
388,Australian Open,Yoshihito Nishioka,3,4,7,42.86
389,Australian Open,Younes El Aynaoui,10,5,15,66.67
