,tournament,fullname,Count_Win,Count_Lose,total_play,perc_win
1,French Open,Adrian Mannarino,3,11,14,21.43
4,French Open,Agustin Calleri,3,8,11,27.27
5,French Open,Albert Costa,18,5,23,78.25999999999999
6,French Open,Albert Montanes,16,14,30,53.33
7,French Open,Albert Portas,5,6,11,45.45
8,French Open,Albert Ramos,10,9,19,52.629999999999995
9,French Open,Alberto Martin,5,8,13,38.46
10,French Open,Alejandro Falla,7,10,17,41.18
13,French Open,Alex Calatrava,2,4,6,33.33
14,French Open,Alex Corretja,17,5,22,77.27000000000001
18,French Open,Alexander Zverev,10,4,14,71.43
19,French Open,Alexandr Dolgopolov,6,7,13,46.150000000000006
21,French Open,Aljaz Bedene,3,6,9,33.33
23,French Open,Andre Agassi,13,6,19,68.42
26,French Open,Andreas Beck,2,5,7,28.57
27,French Open,Andreas Haider Maurer,2,6,8,25.0
28,French Open,Andreas Seppi,11,14,25,44.0
31,French Open,Andrei Pavel,5,7,12,41.67
35,French Open,Andrey Golubev,1,5,6,16.669999999999998
36,French Open,Andrey Kuznetsov,3,5,8,37.5
37,French Open,Andy Murray,39,10,49,79.59
38,French Open,Andy Roddick,9,10,19,47.370000000000005
41,French Open,Antony Dupuis,2,6,8,25.0
42,French Open,Arnaud Clement,10,12,22,45.45
43,French Open,Arnaud Di Pasquale,3,4,7,42.86
44,French Open,Attila Savolt,4,3,7,57.14
46,French Open,Benjamin Becker,2,7,9,22.220000000000002
48,French Open,Benoit Paire,11,10,21,52.38
49,French Open,Bernard Tomic,3,10,13,23.080000000000002
51,French Open,Blaz Kavcic,4,5,9,44.440000000000005
53,French Open,Bohdan Ulihrach,4,5,9,44.440000000000005
54,French Open,Borna Coric,9,5,14,64.29
57,French Open,Carlos Berlocq,5,10,15,33.33
58,French Open,Carlos Moya,20,9,29,68.97
62,French Open,Cedric Pioline,4,3,7,57.14
67,French Open,Christophe Rochus,5,9,14,35.709999999999994
69,French Open,Damir Dzumhur,4,6,10,40.0
71,French Open,Daniel Gimeno Traver,4,8,12,33.33
72,French Open,David Ferrer,44,16,60,73.33
73,French Open,David Goffin,16,8,24,66.67
75,French Open,David Nalbandian,20,8,28,71.43
76,French Open,David Sanchez,5,5,10,50.0
77,French Open,Davide Sanguinetti,3,6,9,33.33
78,French Open,Denis Istomin,6,10,16,37.5
83,French Open,Diego Sebastian Schwartzman,9,6,15,60.0
85,French Open,Dmitry Tursunov,10,11,21,47.620000000000005
86,French Open,Dominic Thiem,24,6,30,80.0
87,French Open,Dominik Hrbaty,6,9,15,40.0
88,French Open,Donald Young,2,6,8,25.0
89,French Open,Dudi Sela,2,9,11,18.18
90,French Open,Dusan Lajovic,8,6,14,57.14
92,French Open,Edouard Roger Vasselin,5,7,12,41.67
93,French Open,Eduardo Schwank,4,4,8,50.0
96,French Open,Ernests Gulbis,17,13,30,56.67
99,French Open,Fabio Fognini,21,11,32,65.62
100,French Open,Fabrice Santoro,9,10,19,47.370000000000005
103,French Open,Federico Delbonis,3,7,10,30.0
104,French Open,Feliciano Lopez,12,19,31,38.71
105,French Open,Felix Mantilla,6,5,11,54.55
106,French Open,Fernando Gonzalez,20,10,30,66.67
107,French Open,Fernando Meligeni,4,3,7,57.14
108,French Open,Fernando Verdasco,32,16,48,66.67
109,French Open,Fernando Vicente,10,8,18,55.559999999999995
111,French Open,Filippo Volandri,6,9,15,40.0
113,French Open,Flavio Saretta,6,5,11,54.55
114,French Open,Florent Serra,7,10,17,41.18
115,French Open,Florian Mayer,3,11,14,21.43
117,French Open,Franco Squillari,9,4,13,69.23
118,French Open,Gael Monfils,36,13,49,73.47
119,French Open,Galo Blanco,7,5,12,58.330000000000005
120,French Open,Gaston Gaudio,19,8,27,70.37
122,French Open,Gilles Muller,2,9,11,18.18
123,French Open,Gilles Simon,21,14,35,60.0
125,French Open,Greg Rusedski,1,6,7,14.29
128,French Open,Grigor Dimitrov,9,9,18,50.0
130,French Open,Guido Pella,4,5,9,44.440000000000005
131,French Open,Guillaume Rufin,2,4,6,33.33
132,French Open,Guillermo Canas,14,7,21,66.67
133,French Open,Guillermo Coria,17,7,24,70.83
134,French Open,Guillermo Garcia Lopez,13,16,29,44.83
135,French Open,Gustavo Kuerten,24,5,29,82.76
139,French Open,Hicham Arazi,6,5,11,54.55
140,French Open,Horacio Zeballos,7,6,13,53.849999999999994
144,French Open,Hyung Taik Lee,5,6,11,45.45
145,French Open,Igor Andreev,13,7,20,65.0
146,French Open,Igor Sijsling,2,5,7,28.57
149,French Open,Ivan Dodig,1,6,7,14.29
150,French Open,Ivan Ljubicic,18,12,30,60.0
152,French Open,Ivo Karlovic,8,14,22,36.36
155,French Open,Jack Sock,8,6,14,57.14
157,French Open,James Blake,6,9,15,40.0
159,French Open,Jan Hajek,3,4,7,42.86
161,French Open,Jan Lennard Struff,5,7,12,41.67
162,French Open,Jan Michael Gambill,1,5,6,16.669999999999998
163,French Open,Janko Tipsarevic,12,13,25,48.0
165,French Open,Jarkko Nieminen,13,12,25,52.0
168,French Open,Jean Rene Lisnard,2,8,10,20.0
170,French Open,Jeremy Chardy,18,13,31,58.06
172,French Open,Jerzy Janowicz,5,4,9,55.559999999999995
174,French Open,Jiri Novak,9,7,16,56.25
175,French Open,Jiri Vanek,3,6,9,33.33
176,French Open,Jiri Vesely,4,7,11,36.36
177,French Open,Jo Wilfried Tsonga,28,11,39,71.78999999999999
178,French Open,Joao Sousa,4,8,12,33.33
179,French Open,John Isner,17,10,27,62.96000000000001
181,French Open,Jonas Bjorkman,5,9,14,35.709999999999994
182,French Open,Jordan Thompson,3,4,7,42.86
183,French Open,Jose Acasuso,7,8,15,46.67
184,French Open,Josselin Ouanna,3,3,6,50.0
186,French Open,Juan Carlos Ferrero,34,11,45,75.56
187,French Open,Juan Ignacio Chela,15,12,27,55.559999999999995
189,French Open,Juan Martin Del Potro,22,9,31,70.97
190,French Open,Juan Monaco,13,13,26,50.0
193,French Open,Julien Benneteau,16,16,32,50.0
194,French Open,Julien Boutter,1,5,6,16.669999999999998
197,French Open,Jurgen Melzer,16,13,29,55.169999999999995
198,French Open,Jurgen Zopp,3,4,7,42.86
199,French Open,Karen Khachanov,10,3,13,76.92
201,French Open,Karol Kucera,3,4,7,42.86
202,French Open,Kei Nishikori,22,9,31,70.97
204,French Open,Kevin Anderson,17,9,26,65.38000000000001
208,French Open,Kristian Pless,2,5,7,28.57
209,French Open,Kristof Vliegen,3,7,10,30.0
210,French Open,Kyle Edmund,7,4,11,63.63999999999999
211,French Open,Lars Burgsmuller,4,5,9,44.440000000000005
214,French Open,Leonardo Mayer,14,10,24,58.330000000000005
215,French Open,Lleyton Hewitt,28,13,41,68.28999999999999
217,French Open,Lucas Pouille,7,7,14,50.0
218,French Open,Luis Horna,5,6,11,45.45
219,French Open,Lukas Dlouhy,3,3,6,50.0
220,French Open,Lukas Lacko,1,5,6,16.669999999999998
221,French Open,Lukas Rosol,6,7,13,46.150000000000006
222,French Open,Lukasz Kubot,5,6,11,45.45
224,French Open,Magnus Norman,6,4,10,60.0
225,French Open,Malek Jaziri,3,6,9,33.33
226,French Open,Marat Safin,20,9,29,68.97
227,French Open,Marc Gicquel,4,8,12,33.33
230,French Open,Marcel Granollers,12,10,22,54.55
233,French Open,Marco Cecchinato,5,3,8,62.5
235,French Open,Marco Trungelliti,3,3,6,50.0
236,French Open,Marcos Baghdatis,10,13,23,43.480000000000004
237,French Open,Marcos Daniel,1,5,6,16.669999999999998
239,French Open,Mardy Fish,4,6,10,40.0
240,French Open,Mariano Puerta,11,5,16,68.75
241,French Open,Mariano Zabaleta,9,6,15,60.0
242,French Open,Marin Cilic,25,13,38,65.79
244,French Open,Mario Ancic,11,5,16,68.75
245,French Open,Mark Philippoussis,5,4,9,55.559999999999995
249,French Open,Martin Klizan,9,8,17,52.94
250,French Open,Martin Vassallo Arguello,6,5,11,54.55
251,French Open,Martin Verkerk,8,3,11,72.72999999999999
254,French Open,Mathieu Montcourt,3,3,6,50.0
256,French Open,Max Mirnyi,1,8,9,11.110000000000001
259,French Open,Maximo Gonzalez,3,4,7,42.86
260,French Open,Michael Berrer,3,5,8,37.5
261,French Open,Michael Chang,3,4,7,42.86
262,French Open,Michael Llodra,10,15,25,40.0
263,French Open,Michael Russell,3,7,10,30.0
265,French Open,Michel Kratochvil,3,4,7,42.86
268,French Open,Mikhail Kukushkin,4,8,12,33.33
269,French Open,Mikhail Youzhny,23,18,41,56.10000000000001
270,French Open,Milos Raonic,14,6,20,70.0
272,French Open,Mischa Zverev,2,8,10,20.0
273,French Open,Nick Kyrgios,5,5,10,50.0
274,French Open,Nicolas Almagro,24,14,38,63.160000000000004
275,French Open,Nicolas Coutelot,5,3,8,62.5
276,French Open,Nicolas Devilder,3,4,7,42.86
277,French Open,Nicolas Escude,3,5,8,37.5
279,French Open,Nicolas Kiefer,8,7,15,53.33
280,French Open,Nicolas Lapentti,10,10,20,50.0
281,French Open,Nicolas Mahut,8,17,25,32.0
282,French Open,Nicolas Massu,8,9,17,47.06
283,French Open,Nikolay Davydenko,26,13,39,66.67
284,French Open,Nikoloz Basilashvili,2,5,7,28.57
285,French Open,Novak Djokovic,68,14,82,82.93
287,French Open,Olivier Mutis,4,2,6,66.67
288,French Open,Olivier Patience,4,6,10,40.0
289,French Open,Olivier Rochus,7,11,18,38.89
291,French Open,Oscar Hernandez,5,7,12,41.67
293,French Open,Pablo Andujar,7,10,17,41.18
294,French Open,Pablo Carreno Busta,10,7,17,58.81999999999999
295,French Open,Pablo Cuevas,11,10,21,52.38
296,French Open,Paolo Lorenzi,1,8,9,11.110000000000001
297,French Open,Paradorn Srichaphan,3,6,9,33.33
299,French Open,Paul Capdeville,2,4,6,33.33
301,French Open,Paul Henri Mathieu,17,15,32,53.12
302,French Open,Pere Riba,2,4,6,33.33
305,French Open,Philipp Kohlschreiber,14,15,29,48.28
306,French Open,Philipp Petzschner,2,5,7,28.57
307,French Open,Pierre Hugues Herbert,4,5,9,44.440000000000005
308,French Open,Potito Starace,6,9,15,40.0
310,French Open,Radek Stepanek,14,13,27,51.849999999999994
311,French Open,Radu Albot,2,4,6,33.33
312,French Open,Raemon Sluiter,4,6,10,40.0
313,French Open,Rafael Nadal,93,2,95,97.89
314,French Open,Rainer Schuettler,4,11,15,26.669999999999998
316,French Open,Richard Gasquet,27,16,43,62.79
318,French Open,Robby Ginepri,6,9,15,40.0
320,French Open,Roberto Bautista Agut,14,7,21,66.67
322,French Open,Robin Haase,5,11,16,31.25
323,French Open,Robin Soderling,19,8,27,70.37
325,French Open,Roger Federer,70,16,86,81.39999999999999
326,French Open,Rogerio Dutra Silva,1,5,6,16.669999999999998
329,French Open,Ruben Ramirez Hidalgo,4,5,9,44.440000000000005
331,French Open,Ryan Harrison,1,5,6,16.669999999999998
333,French Open,Sam Querrey,5,12,17,29.409999999999997
334,French Open,Santiago Giraldo,4,12,16,25.0
335,French Open,Sargis Sargsian,4,6,10,40.0
338,French Open,Sebastien Grosjean,17,8,25,68.0
340,French Open,Sergiy Stakhovsky,7,10,17,41.18
341,French Open,Simone Bolelli,9,13,22,40.910000000000004
342,French Open,Sjeng Schalken,5,4,9,55.559999999999995
345,French Open,Stan Wawrinka,42,14,56,75.0
346,French Open,Stefan Koubek,5,8,13,38.46
347,French Open,Stefano Galvani,1,5,6,16.669999999999998
349,French Open,Stefanos Tsitsipas,4,3,7,57.14
350,French Open,Stephane Robert,2,7,9,22.220000000000002
351,French Open,Steve Darcis,4,9,13,30.769999999999996
352,French Open,Steve Johnson,7,7,14,50.0
353,French Open,Taro Daniel,2,4,6,33.33
356,French Open,Teymuraz Gabashvili,10,8,18,55.559999999999995
359,French Open,Thiemo De Bakker,2,4,6,33.33
360,French Open,Thierry Ascione,1,6,7,14.29
361,French Open,Thomas Enqvist,8,6,14,57.14
363,French Open,Thomas Johansson,3,7,10,30.0
365,French Open,Thomaz Bellucci,8,10,18,44.440000000000005
366,French Open,Tim Henman,14,8,22,63.63999999999999
367,French Open,Tobias Kamke,4,6,10,40.0
368,French Open,Todd Martin,2,5,7,28.57
369,French Open,Tomas Behrend,1,5,6,16.669999999999998
370,French Open,Tomas Berdych,25,15,40,62.5
371,French Open,Tommy Haas,19,11,30,63.33
372,French Open,Tommy Robredo,37,14,51,72.55
374,French Open,Victor Estrella,2,4,6,33.33
375,French Open,Victor Hanescu,16,11,27,59.260000000000005
376,French Open,Viktor Troicki,15,9,24,62.5
377,French Open,Vincent Spadea,6,8,14,42.86
379,French Open,Wayne Arthurs,4,7,11,36.36
380,French Open,Wayne Ferreira,4,5,9,44.440000000000005
383,French Open,Xavier Malisse,13,10,23,56.52
385,French Open,Yen Hsun Lu,2,9,11,18.18
386,French Open,Yevgeny Kafelnikov,10,4,14,71.43
388,French Open,Younes El Aynaoui,7,4,11,63.63999999999999
